
                                                                 
                                                                                o     -
                                                                               o o    *
                     o 1 o    o   o                                           o o o   *
             1      GGGGGGG  GGGGGGG       oooo         1                    o o o o  *
            GG                             GGGG        GGG                            *
                                                                             GG       *
                 GG                   GG                       GG           GGG       *
 P      GG  1    GG     1      1      GG    1   1      1   1   GG   1  1   GGGG  1    =
GGGGGGGGGGGGGGGGGGGGGGGGGGGGGGGGGGGGGGGGGGGGGGGGGGGGGGGGGGGGGGGGGGGGGGGGGGGGGGGGGGGGGGGG